FFFFFFFFFFFF
FFGGGGGFGGFG
GGGFGGMGGFGG
MGMGMGGGGGMM
MMGGGGFGGGGG
MGMGGGFFFGGG
GGGGGMGGGGGM
FFGGGGMFGGGF